2202220222200

0202020200200

0202020200200

0202020200200

0202020200200

0202020200200

0222022200220
0000000000000