220222022220000000

020202020020000000

020202020020000000

020202020020000000

020202020020000000

020202020020000000

022202220022000000
000000000000000000